t t t t t t t 2 S 2 t t t t t t t t
t t t t t t 1 2 0 2 1 t t t t 2 2 2
t t t t t t t 2 0 2 t t t 2 2 2 2 2
t t t t t t 1 2 0 2 1 t t 2 2 2 2 2
t t t t t t t 2 0 2 t t t t 2 2 2 2
t t t t t t 1 2 0 2 1 t t t t t t 2
t t t t t t t 2 0 2 t t t t t t t t
t t t t t t 1 2 0 2 1 t t t t t t t
t t t t t t t 2 0 2 t t t t t t t t
t t t t t t 1 2 0 2 1 t t t t t t t
t t t t t t t 2 0 2 t t t t t t t t
t t t t t t 1 2 0 2 1 t t t t t t t
t t t t t t t 2 0 2 t t t t t t t t
t t t t t t 1 2 0 2 1 t t t t t t t
t t t t t t t 2 0 2 t t t t t t t t
t t t t t t 1 2 0 2 1 t t t t t t t
t t t t t t t 2 0 2 t t t t t t t t
t t t t t t t 2 E 2 t t t t t t t t
