t t t t t 1 1 t t 2 2 2 2 t t E t t
t t t t t 1 1 1 1 2 2 2 2 1 1 0 t t
t t t 1 1 1 t 1 1 2 2 2 2 1 1 0 t t
S 0 0 0 0 0 1 t t 2 2 2 1 1 1 0 t t
1 1 1 t 1 0 1 t t 2 2 2 1 t 1 0 1 t
t t 1 1 1 0 1 1 2 2 2 2 1 1 1 0 1 t
t t 1 1 1 0 1 1 2 2 2 t 1 1 1 0 1 t
t 1 t t 1 0 t 2 2 2 2 1 0 0 0 0 1 t
t 1 t t 1 0 0 2 2 2 1 1 0 1 t t t t
t t 1 1 2 2 0 2 2 2 1 1 0 1 t t t t
t t 1 2 2 2 0 2 2 2 1 1 0 1 t t t t
2 2 2 2 2 2 0 2 2 1 t t 0 0 0 0 0 t
2 2 2 2 2 2 0 1 1 1 t t t t 1 1 0 t
2 2 2 2 1 1 0 1 1 1 t t t t 1 t 0 t
2 2 1 1 1 1 0 0 0 0 0 0 0 0 0 0 0 t
t t t 1 1 1 t t 1 1 1 t t 1 1 1 1 t
t t t t t t t t t t t t t t t t t t
t t t t t t t t t t t t t t t t t t
